{
  "map":[
    [1,1,1,1,1,1,1,1],
    [1,0,1,1,1,1,0,1],
    [0,0,1,1,1,1,1,1],
    [1,1,0,0,1,0,1,1],
    [1,1,1,1,1,1,1,1],
    [1,0,1,0,1,1,0,1],
    [1,1,1,0,0,0,0,1],
    [1,1,1,1,1,1,1,1]
  ],
  "size":{
    "x":1,
    "y":1
  }
}